0000000000000000
0001000000001000
0001001000010000
0001000010000001
0101000000000000
0001000000000000
0101010000100001
0101000000
0101000000001000
0001000000001000
0001000000001000
0001000000001000